F  6, 205,128
C 135,206,255
S ./xpms/barrel.xpm

NO ./xpms/mossy.xpm
SO ./xpms/wood.xpm
WE ./xpms/stone.xpm
EA ./xpms/redstone.xpm
R 1600 900

0000111
000012100000
1111101111111111111
1222222222222221111
1222222222222221111
1222222222222221111
1222222222222221111
1222222222222221111
1222222222222221111
1000000000000000011
10N021220002000011
11111111111111111