F  6, 205,128
C 135,206,255
S /Users/lduhamel/septembre/xpms/barrel.xpm

NO  /Users/lduhamel/septembre/xpms/mossy.xpm
SO /Users/lduhamel/septembre/xpms/wood.xpm
WE /Users/lduhamel/septembre/xpms/stone.xpm
EA /Users/lduhamel/septembre/xpms/redstone.xpm
R 1600 900

1111111111111111111
1222210000000010001
1220010111111000101
1220000100011000121
1111111101011011111
1000000001001011111
1000110011101000001
1002111112101110001
1021120000100010001
1011211010121000001
100000001N121000221
1111111111111111111