F  6, 205,128
C 135,206,255
S ./xpms/barrel.xpm

NO ./xpms/mossy.xpm
SO ./xpms/wood.xpm
WE ./xpms/stone.xpm
EA ./xpms/redstone.xpm
R 1600 900

111111111111111111111111
100000000000000100000001
100000000000000100000001
101000000000000100000001
100000111110000100000001
100000111110000100000001
100000111110000100000001
100000111110000100000001
100000111110000100000001
100000000000000100000001
100000000000000100000001
100000000000000100000001
100000000000000100000001
100000000000000100000001
110101010101010101010101
100100000000000000000001
101111111111100100000001
100000000000100100000001
111111110110100000001001
120001000111100000001001
120100011100000110001001
100101110100000100001001
10N121000100000000001001
111111111111111111111111